#00&0==&&&0==&&#
#........0....0#
#......_f_....=#
#......_=_....=#
#=000_=._.....=#
#...e_.._...e.=#
#=00=_0._.==0_0#
#...._.._...._.#
#...._.._@.00_0#
#...._.._==.._.#
#e..._._....._.#
#0=00=&000&===0#
