..._....
..._....
..._....
..#_...F
..@_._#=
00000000
