................
.........e.....F
......._=====_=#
......F_.e..._==
@...._#========#
0000000000000000
