#==0&&==&&0&=00#
#....&.....0...#
#....&.....0...#
#..e...e.......#
#_&00=0=&=_00&_#
#_........_..._#
#_===00==&_&0=_#
#_........_..._#
#_.@......_&&._#
#_00=....._e._f#
#==&&&=0&00&._&#
#00&00&0=0===00#
