#=&=00==0==&==&#
#.....=.0...=..#
#.....=.0...0..#
#.......=......#
#.....=&&&_&&=_#
#.....0..._..._#
#.....e..._..._#
#0&0_00..._..._#
#..._.&..._..._#
#..._.0..._..._#
#.c._....._..@_#
#&0&0&&&===00&0#
