#&&00=&===000=0#
#..............#
#..............#
#..............#
#..............#
#.......xxx....#
#.......x@x....#
#.......&&&....#
#..............#
#..............#
#.......xfx....#
#0==&===&&=0&=&#
