#&&=&=&&0&&0=0&#
#....._c_0.....#
#_=000_=_0.....#
#_e..._._&.....#
#_&000_&_&.....#
#_...._._......#
#_====_=_0._...#
#_...._._.._@..#
#_e..._._._&0_.#
#_&=0=_=_=_0=_&#
#_..e._._._.._.#
#&0=0=0=0&0=&&0#
