#==0====0&&0&&=#
#...0......&...#
#...&......=...#
#...0......&...#
#...0......=...#
#=.....e.......#
#.@.&&_=&0&=_&0#
#_&0.._e...._..#
#_&&_0_0=&0=_0=#
#_0._._....._..#
#_..c._..e.._..#
#===0=&&00&&&&0#
