#=0&=&&==00&&0&#
#xxx...........#
#x@x...........#
#0=0.......xcx.#
#...........=..#
#..............#
#..............#
#..............#
#..............#
#..............#
#..............#
#&0&00=0&==&&0&#
