#==0&===0&&0=00#
#..............#
#..............#
#..............#
#..............#
#..............#
#......xxx.....#
#......x@x.....#
#......0&&.....#
#..............#
#..............#
#0&&&0=&0&&&&0=#
