#0=&00&00&=0=0&#
#...0........=.#
#_c_0........=.#
#_=_=........=.#
#_=_&...@....0.#
#_._..._0&...0.#
#_._..e_.......#
#_0_=00_==&_&=0#
#_._..._e.e_...#
#_=_=0=_&0=_&&=#
#_._..._..._...#
#&&00&0&&0&=&&&#
