#=&=&&=&==&=&&=#
#..............#
#..___=...e...e#
#_....&=&^=&^=_#
#._....@===&=&_#
#^^==&=&&=&=&&_#
#=%%t.e........#
#..=%%%&=e.__..#
#e_.....&&=^^=.#
#_.e_.....&==&&#
#e._.......&e..#
0&&0&00&&0&&0&&0