#==&&=&=&&==&=&#
#%%%%&%...&&&&&#
#%%.e&%&%%%&..e#
#_&_&&%&%&%%%&&#
#_%%%%%.^&%&_%%#
#&%.&&%&&&&&&&_#
#%%_%&%%%.%%%&_#
#%&&&&%%&&&&_&_#
#_%%%%&&&.%%_%_#
#&&&%%%%%%&&&&&#
#@%%%&&&&%%..e.#
0&0&00&0&&&00&&0