#&=&==&&=&=&==&#
#..............#
#....e.....=.@.#
#__&&=&&=&=&&=&#
#............e.#
#=&&=&...e.__&_#
#&...=&=&=^^^&.#
#=.......=&&==.#
#&=_...e.....=.#
#e._..._.....&.#
#_._.e.........#
0&0&&0&00&0&0&00