#=&=&&=&==&=&&=#
#..............#
#..___=...e...e#
#_....&=&^=&^=_#
#._....@===&=%_#
#^^==&=&&=&=&%_#
#=%%t.e........#
#..=%%%&=e.._..#
#e_.....&&=^^_^#
#_.e_.....&==&&#
#e._.......&e..#
0&&0&00&&0&&0&&0