#=&=&==&&=&==&=#
#..............#
#......e.....F.#
#_&=&=&=&&==&=&#
#_.............#
#_.............#
#_....e..%.....#
#==&=&=&&=&==&_#
#............._#
#.......=...._=#
#@.H.=._&_.=^^&#
0&&00=0&0&0&0&00