#==============#
#..............#
#...e......e...#
#e.._......_..e#
#_............_#
#=======_...._.#
#..=....=====_.#
#.@=.....e..=._#
#_#=..=====_=_.#
#..._.=......._#
#...._=.e...._.#
0000000000000000