#==============#
#..............#
#..___=...e...e#
#_....===^==^=_#
#._....@=====._#
#^^^=========._#
#=%%t.e........#
#..=%%%&&&e....#
#e_.......=^=.^#
#_.e_......====#
#e._.......=e..#
0000000000000000