#&==&==&&=&=&&=#
#e..=......&&&&#
#_...._........#
#..___.._.=e...#
#^^^^^..._===_.#
#=======^^=e.._#
#..=...======_.#
#.@=.....e..=._#
#_&=..=====_=_.#
#..._.=......._#
#...._=.e...._.#
00&0&&0&00&&&0&0