#==============#
#..............#
#......e.....F.#
#_&&&&&=&&&&&=&#
#_.............#
#_.............#
#_....e........#
#=&&&&=&&&&&&=_#
#............._#
#.......=....&=#
#.@..=._&_.=&&&#
0000000000000000