================
=..............=
=......e.....F.=
=_==============
=_.............=
=_.............=
=_....e........=
==============_=
=............._=
=.......=....===
=.@..=._=_.=====
================