#==============#
#..............#
#..___=...e...e#
#_....===^==^=_#
#._._..@=====._#
#^^^^========._#
#====.....e....#
#.........#....#
#.........=^=.^#
#..........====#
#te..e.....=e.C#
0000000000000000