#==============#
#..............#
#......ee......#
#__._.====._.__#
#._.........._.#
#.._........_..#
#.._....@..._.B#
#==._.____._.==#
#..............#
#..............#
#^^^^^^^^^^^^^^#
0000000000000000