================
=..............=
=4.....44.....4=
=__._.====._.__=
=._.........._.=
=.._........_..=
=4._....@..._.B=
===._.____._.===
=..............=
=..............=
=^^^^^^^^^^^^^^=
================