#==============#
#..............#
#....e.......@.#
#__============#
#...........e..#
#=====.....__=_#
#.....===#^^^=.#
#.........====.#
#_#....e.....=.#
#_....._.......#
#_...e...._....#
0000000000000000