#==============#
#..............#
#......e.....F.#
#_=&&&&=&&&&&=&#
#_.............#
#_.............#
#_....e........#
#=&&&&=&&&&&&=_#
#............._#
#.......=....&=#
#.@..=._#_.=&&&#
00=&=#=&#&=0&&&0