#==============#
#..............#
#..___=...e...e#
#_....===^==^=_#
#._._C.@=====._#
#^^^^========._#
#====.....e....#
#.........#....#
#.........=^=.^#
#..........====#
#te........=e.C#
0000000000000000