#==============#
#..............#
#e.....ee.....e#
#__._.====._.__#
#._.........._.#
#.._........_..#
#e._....@..._.e#
#==._.____._.==#
#..............#
#..............#
#^^^^^^^^^^^^^^#
0000000000000000