================
=..............=
=....e.......@.=
=__=============
=..............=
======.....__=_=
=.....===#.e.=.=
=.C.......====.=
=_#....e.....=.=
=_....._.......=
=_...e.........=
================