................................................................
...................................==================...........
...................................=e..............e=...........
..@................................=________________=...........
=====================..............=e._....__...._.e=.....#====#
=========================..........=________________=.....=....=
=========================_...................................F.=
0000000000000000000000000000000000000000000000000000000000000000