#==============#
#..............#
#....e.......@.#
#__============#
#..............#
#=====.....__=_#
#.....===#.e.=.#
#.........====.#
#_#....e.....=.#
#_....._.......#
#_...e...._....#
0000000000000000