================
=..............=
=...e......e...=
=e.._......_..e=
=_......t....._=
========_......=
=..=....=====_.=
=.@=.....e..=._=
=_#=..=====_=_.=
=..._.=......._=
=...._=.e...._.=
================