================
=%%..=%...======
=_=.e=%=%%%=..e=
=_=_==%=%=%%_===
=_%%%%%.^=%=_%%=
==%.==========_=
=.%_%%=%%%%%%=_=
=%====%%====_=_=
=_.%%%===%%%_%_=
====%%%%%.======
=@%%%====%%..e.=
0000000000000000