................
................
................
................
................
................
...._...........
...._........F..
...._........#..
...._...@..._=_.
...._._.#..._=_.
0000000000000000