#=========#========#==========#======#==============#===========
#=========#=========...===............e..===============#=======
=..................=_=_..._=======_=====_=.....................=
=..................=__===_==..........==.=..........B..........=
#..................==_.......===_====_.=.=__._._._.___._._._.__#
=................#_====_====_===_...====.=.........___.........=
=..@.......e...._=_.t.._.....e=====...==..T........___.........=
0000000000000000000000000000000000000000000000000000000000000000