================
=..............=
=....e.......@.=
=__=============
=..............=
======.....__=_=
=.....===#.e.=.=
=.........====.=
=_#....e.....=.=
=_....._.......=
=_...e...._....=
================