================
=..............=
=..___=...e...e=
=_....===^==^=_=
=._._..@=====._=
=^^^^========._=
=====..........=
=.........#....=
=.........=^=.^=
=..........=====
=te..e....e=..C=
================