================
=%%..=%...======
=_=.e=%=%%%=..e=
=_=_==%=%=%%_===
=_..^%%S^=%=_%%=
==%.==========_=
=.%_%%=%%%%%%=_=
=%====%%====_=_=
=_.%%====%%%_%_=
====%%%%%.======
=@%%%====%%..e.=
================