#==============#
#..............#
#..............#
#__._.====._.__#
#._.........._.#
#.._........_..#
#.._....@..._.B#
#==._.____._.==#
#..............#
#e.............#
#^^^^^^^^^^^^^^#
0000000000000000