#==============#
#..............#
#..............#
#__._.____._.__#
#._.........._.#
#.._........_..#
#.._....@..._.B#
#__._.____._.__#
#..............#
#e.............#
#^^^^^^^^^^^^^^#
#==============#