#==============#
#..............#
#....e.....=.@.#
#__============#
#...........e..#
#=====...e.__=_#
#.....===#^^^=.#
#.........====.#
###_...e.....=.#
#e._..._.....=.#
#_._.e...._....#
0000000000000000