........
........
........
..#=_..F
@...._##
00000000
