................
.........e.....F
......._=====_##
......._.e..._##
@...._##########
0000000000000000
