........
........
........
..#_...F
..@_._#=
00000000
